{15,15,10,15,15,15,15,15,15,15;15,10,10,15,15,15,15,15,18,1;15,10,10,15,15,15,18,1,17,19;10,10,15,15,15,18,17,19,8,3;15,10,15,15,18,17,8,3,2,15;10,15,10,18,17,8,2,15,15,15;15,10,18,17,8,2,15,15,15,15;15,18,17,19,12,15,15,15,15,15;15,16,19,8,2,15,15,15,15,15;15,16,19,12,15,15,15,15,15,15;}{2,2,2,2,2,2,2,2,2,2;3,3,2,2,2,2,2,2,2,2;4,4,3,3,3,2,2,2,2,2;4,4,4,4,4,3,2,2,2,2;3,3,4,4,4,4,3,2,2,2;1,2,3,3,4,4,4,3,2,2;1,1,1,2,3,4,4,3,2,2;1,1,1,2,2,3,4,4,3,2;1,1,1,1,2,2,3,4,4,3;1,1,1,1,1,2,3,4,4,3;}{2,2,5,2,2,2,2,2,2,2;2,5,5,2,2,2,2,2,2,3;2,5,5,2,2,2,3,3,3,4;5,5,2,2,2,3,4,4,4,4;2,5,2,2,3,4,4,4,4,3;5,2,5,3,4,4,4,3,3,1;2,5,3,4,4,4,3,2,2,1;2,5,3,4,4,3,2,2,1,1;2,3,4,4,4,3,2,1,1,1;2,3,4,4,3,2,1,1,1,1;}{2,2,2,2,2,2,2,2,2,2;3,3,2,2,2,2,2,2,2,2;4,4,3,3,3,2,2,2,2,2;4,4,4,4,4,3,2,2,2,2;3,3,4,4,4,4,3,2,2,2;1,2,3,3,4,4,4,3,2,2;1,1,1,2,3,4,4,3,2,2;1,1,1,2,2,3,4,4,3,2;1,1,1,1,2,2,3,4,4,3;1,1,1,1,1,2,3,4,4,3;}{2,2,5,2,2,2,2,2,2,2;2,5,5,2,2,2,2,2,2,3;2,5,5,2,2,2,3,3,3,4;5,5,2,2,2,3,4,4,4,4;2,5,2,2,3,4,4,4,4,3;5,2,5,3,4,4,4,3,3,1;2,5,3,4,4,4,3,2,2,1;2,5,3,4,4,3,2,2,1,1;2,3,4,4,4,3,2,1,1,1;2,3,4,4,3,2,1,1,1,1;}{2,2,2,2,2,2,2,2,2,2;3,3,2,2,2,2,2,2,2,2;4,4,3,3,3,2,2,2,2,2;4,4,4,4,4,3,2,2,2,2;3,3,4,4,4,4,3,2,2,2;1,2,3,3,4,4,4,3,2,2;1,1,1,2,3,4,4,3,2,2;1,1,1,2,2,3,4,4,3,2;1,1,1,1,2,2,3,4,4,3;1,1,1,1,1,2,3,4,4,3;}
{2,3,4,4,3,2,1,1,1,1;2,2,3,4,4,3,2,1,1,1;2,2,3,4,4,4,3,1,1,1;2,2,2,3,4,4,4,3,2,1;2,2,5,3,4,4,4,3,2,2;2,2,3,4,4,4,4,3,2,2;2,3,4,4,4,3,3,2,2,2;3,4,4,4,3,2,2,2,2,2;3,4,4,3,2,2,2,2,2,2;3,4,4,3,2,2,2,2,2,2;}{1,1,1,1,1,2,3,4,4,3;1,1,1,1,2,2,3,4,4,4;1,1,1,2,2,2,2,3,4,4;1,2,2,2,2,2,2,3,4,4;2,2,2,2,2,2,2,3,4,4;2,2,2,2,2,2,2,2,3,4;2,2,2,2,2,2,2,2,2,3;2,2,2,2,2,2,2,2,2,2;2,2,2,2,2,2,2,2,2,2;2,2,2,2,2,2,2,2,2,2;}{2,2,5,2,2,2,2,2,2,2;2,5,5,2,2,2,2,2,2,3;2,5,5,2,2,2,3,3,3,4;5,5,2,2,2,3,4,4,4,4;2,5,2,2,3,4,4,4,4,3;5,2,5,3,4,4,4,3,3,1;2,5,3,4,4,4,3,2,2,1;2,5,3,4,4,3,2,2,1,1;2,3,4,4,4,3,2,1,1,1;2,3,4,4,3,2,1,1,1,1;}{2,2,2,2,2,2,2,2,2,2;3,3,2,2,2,2,2,2,2,2;4,4,3,3,3,2,2,2,2,2;4,4,4,4,4,3,2,2,2,2;3,3,4,4,4,4,3,2,2,2;1,2,3,3,4,4,4,3,2,2;1,1,1,2,3,4,4,3,2,2;1,1,1,2,2,3,4,4,3,2;1,1,1,1,2,2,3,4,4,3;1,1,1,1,1,2,3,4,4,3;}{2,2,5,2,2,2,2,2,2,2;2,5,5,2,2,2,2,2,2,3;2,5,5,2,2,2,3,3,3,4;5,5,2,2,2,3,4,4,4,4;2,5,2,2,3,4,4,4,4,3;5,2,5,3,4,4,4,3,3,1;2,5,3,4,4,4,3,2,2,1;2,5,3,4,4,3,2,2,1,1;2,3,4,4,4,3,2,1,1,1;2,3,4,4,3,2,1,1,1,1;}{2,2,2,2,2,2,2,2,2,2;3,3,2,2,2,2,2,2,2,2;4,4,3,3,3,2,2,2,2,2;4,4,4,4,4,3,2,2,2,2;3,3,4,4,4,4,3,2,2,2;1,2,3,3,4,4,4,3,2,2;1,1,1,2,3,4,4,3,2,2;1,1,1,2,2,3,4,4,3,2;1,1,1,1,2,2,3,4,4,3;1,1,1,1,1,2,3,4,4,3;}
{3,1,1,1,1,1,1,1,1,1;1,1,1,1,1,1,1,1,1,1;1,1,1,5,1,5,1,1,1,1;1,1,1,1,1,1,1,1,1,1;1,1,5,1,1,1,5,1,1,1;1,1,1,5,5,5,1,1,1,2;1,1,1,1,1,1,1,1,1,2;1,1,1,1,1,1,1,1,2,2;1,1,1,1,1,1,2,2,2,2;1,1,1,1,1,2,2,2,2,2;}{4,1,1,1,1,1,1,1,1,1;1,1,1,1,1,1,1,1,1,1;1,1,1,1,1,1,1,1,1,1;1,1,1,1,1,1,1,1,1,1;1,1,1,1,1,1,1,1,1,1;1,1,1,1,1,1,1,1,1,2;1,1,1,1,1,1,1,1,1,2;1,1,1,1,1,1,1,1,2,2;1,1,1,1,1,1,2,2,2,2;1,1,1,1,1,2,2,2,2,2;}{2,2,5,2,2,2,2,2,2,2;2,5,5,2,2,2,2,2,2,3;2,5,5,2,2,2,3,3,3,4;5,5,2,2,2,3,4,4,4,4;2,5,2,2,3,4,4,4,4,3;5,2,5,3,4,4,4,3,3,1;2,5,3,4,4,4,3,2,2,1;2,5,3,4,4,3,2,2,1,1;2,3,4,4,4,3,2,1,1,1;2,3,4,4,3,2,1,1,1,1;}{2,2,2,2,2,2,2,2,2,2;3,3,2,2,2,2,2,2,2,2;4,4,3,3,3,2,2,2,2,2;4,4,4,4,4,3,2,2,2,2;3,3,4,4,4,4,3,2,2,2;1,2,3,3,4,4,4,3,2,2;1,1,1,2,3,4,4,3,2,2;1,1,1,2,2,3,4,4,3,2;1,1,1,1,2,2,3,4,4,3;1,1,1,1,1,2,3,4,4,3;}{2,2,5,2,2,2,2,2,2,2;2,5,5,2,2,2,2,2,2,3;2,5,5,2,2,2,3,3,3,4;5,5,2,2,2,3,4,4,4,4;2,5,2,2,3,4,4,4,4,3;5,2,5,3,4,4,4,3,3,1;2,5,3,4,4,4,3,2,2,1;2,5,3,4,4,3,2,2,1,1;2,3,4,4,4,3,2,1,1,1;2,3,4,4,3,2,1,1,1,1;}{2,2,2,2,2,2,2,2,2,2;3,3,2,2,2,2,2,2,2,2;4,4,3,3,3,2,2,2,2,2;4,4,4,4,4,3,2,2,2,2;3,3,4,4,4,4,3,2,2,2;1,2,3,3,4,4,4,3,2,2;1,1,1,2,3,4,4,3,2,2;1,1,1,2,2,3,4,4,3,2;1,1,1,1,2,2,3,4,4,3;1,1,1,1,1,2,3,4,4,3;}
{3,1,1,1,1,1,1,1,1,1;1,1,1,1,1,1,1,1,1,1;1,1,1,5,1,5,1,1,1,1;1,1,1,1,1,1,1,1,1,1;1,1,5,1,1,1,5,1,1,1;1,1,1,5,5,5,1,1,1,2;1,1,1,1,1,1,1,1,1,2;1,1,1,1,1,1,1,1,2,2;1,1,1,1,1,1,2,2,2,2;1,1,1,1,1,2,2,2,2,2;}{4,1,1,1,1,1,1,1,1,1;1,1,1,1,1,1,1,1,1,1;1,1,1,1,1,1,1,1,1,1;1,1,1,1,1,1,1,1,1,1;1,1,1,1,1,1,1,1,1,1;1,1,1,1,1,1,1,1,1,2;1,1,1,1,1,1,1,1,1,2;1,1,1,1,1,1,1,1,2,2;1,1,1,1,1,1,2,2,2,2;1,1,1,1,1,2,2,2,2,2;}{2,2,5,2,2,2,2,2,2,2;2,5,5,2,2,2,2,2,2,3;2,5,5,2,2,2,3,3,3,4;5,5,2,2,2,3,4,4,4,4;2,5,2,2,3,4,4,4,4,3;5,2,5,3,4,4,4,3,3,1;2,5,3,4,4,4,3,2,2,1;2,5,3,4,4,3,2,2,1,1;2,3,4,4,4,3,2,1,1,1;2,3,4,4,3,2,1,1,1,1;}{2,2,2,2,2,2,2,2,2,2;3,3,2,2,2,2,2,2,2,2;4,4,3,3,3,2,2,2,2,2;4,4,4,4,4,3,2,2,2,2;3,3,4,4,4,4,3,2,2,2;1,2,3,3,4,4,4,3,2,2;1,1,1,2,3,4,4,3,2,2;1,1,1,2,2,3,4,4,3,2;1,1,1,1,2,2,3,4,4,3;1,1,1,1,1,2,3,4,4,3;}{2,2,5,2,2,2,2,2,2,2;2,5,5,2,2,2,2,2,2,3;2,5,5,2,2,2,3,3,3,4;5,5,2,2,2,3,4,4,4,4;2,5,2,2,3,4,4,4,4,3;5,2,5,3,4,4,4,3,3,1;2,5,3,4,4,4,3,2,2,1;2,5,3,4,4,3,2,2,1,1;2,3,4,4,4,3,2,1,1,1;2,3,4,4,3,2,1,1,1,1;}{2,2,2,2,2,2,2,2,2,2;3,3,2,2,2,2,2,2,2,2;4,4,3,3,3,2,2,2,2,2;4,4,4,4,4,3,2,2,2,2;3,3,4,4,4,4,3,2,2,2;1,2,3,3,4,4,4,3,2,2;1,1,1,2,3,4,4,3,2,2;1,1,1,2,2,3,4,4,3,2;1,1,1,1,2,2,3,4,4,3;1,1,1,1,1,2,3,4,4,3;}
{3,1,1,1,1,1,1,1,1,1;1,1,1,1,1,1,1,1,1,1;1,1,1,5,1,5,1,1,1,1;1,1,1,1,1,1,1,1,1,1;1,1,5,1,1,1,5,1,1,1;1,1,1,5,5,5,1,1,1,2;1,1,1,1,1,1,1,1,1,2;1,1,1,1,1,1,1,1,2,2;1,1,1,1,1,1,2,2,2,2;1,1,1,1,1,2,2,2,2,2;}{4,1,1,1,1,1,1,1,1,1;1,1,1,1,1,1,1,1,1,1;1,1,1,1,1,1,1,1,1,1;1,1,1,1,1,1,1,1,1,1;1,1,1,1,1,1,1,1,1,1;1,1,1,1,1,1,1,1,1,2;1,1,1,1,1,1,1,1,1,2;1,1,1,1,1,1,1,1,2,2;1,1,1,1,1,1,2,2,2,2;1,1,1,1,1,2,2,2,2,2;}{2,2,5,2,2,2,2,2,2,2;2,5,5,2,2,2,2,2,2,3;2,5,5,2,2,2,3,3,3,4;5,5,2,2,2,3,4,4,4,4;2,5,2,2,3,4,4,4,4,3;5,2,5,3,4,4,4,3,3,1;2,5,3,4,4,4,3,2,2,1;2,5,3,4,4,3,2,2,1,1;2,3,4,4,4,3,2,1,1,1;2,3,4,4,3,2,1,1,1,1;}{2,2,2,2,2,2,2,2,2,2;3,3,2,2,2,2,2,2,2,2;4,4,3,3,3,2,2,2,2,2;4,4,4,4,4,3,2,2,2,2;3,3,4,4,4,4,3,2,2,2;1,2,3,3,4,4,4,3,2,2;1,1,1,2,3,4,4,3,2,2;1,1,1,2,2,3,4,4,3,2;1,1,1,1,2,2,3,4,4,3;1,1,1,1,1,2,3,4,4,3;}{2,2,5,2,2,2,2,2,2,2;2,5,5,2,2,2,2,2,2,3;2,5,5,2,2,2,3,3,3,4;5,5,2,2,2,3,4,4,4,4;2,5,2,2,3,4,4,4,4,3;5,2,5,3,4,4,4,3,3,1;2,5,3,4,4,4,3,2,2,1;2,5,3,4,4,3,2,2,1,1;2,3,4,4,4,3,2,1,1,1;2,3,4,4,3,2,1,1,1,1;}{2,2,2,2,2,2,2,2,2,2;3,3,2,2,2,2,2,2,2,2;4,4,3,3,3,2,2,2,2,2;4,4,4,4,4,3,2,2,2,2;3,3,4,4,4,4,3,2,2,2;1,2,3,3,4,4,4,3,2,2;1,1,1,2,3,4,4,3,2,2;1,1,1,2,2,3,4,4,3,2;1,1,1,1,2,2,3,4,4,3;1,1,1,1,1,2,3,4,4,3;}
{3,1,1,1,1,1,1,1,1,1;1,1,1,1,1,1,1,1,1,1;1,1,1,5,1,5,1,1,1,1;1,1,1,1,1,1,1,1,1,1;1,1,5,1,1,1,5,1,1,1;1,1,1,5,5,5,1,1,1,2;1,1,1,1,1,1,1,1,1,2;1,1,1,1,1,1,1,1,2,2;1,1,1,1,1,1,2,2,2,2;1,1,1,1,1,2,2,2,2,2;}{4,1,1,1,1,1,1,1,1,1;1,1,1,1,1,1,1,1,1,1;1,1,1,1,1,1,1,1,1,1;1,1,1,1,1,1,1,1,1,1;1,1,1,1,1,1,1,1,1,1;1,1,1,1,1,1,1,1,1,2;1,1,1,1,1,1,1,1,1,2;1,1,1,1,1,1,1,1,2,2;1,1,1,1,1,1,2,2,2,2;1,1,1,1,1,2,2,2,2,2;}{2,2,5,2,2,2,2,2,2,2;2,5,5,2,2,2,2,2,2,3;2,5,5,2,2,2,3,3,3,4;5,5,2,2,2,3,4,4,4,4;2,5,2,2,3,4,4,4,4,3;5,2,5,3,4,4,4,3,3,1;2,5,3,4,4,4,3,2,2,1;2,5,3,4,4,3,2,2,1,1;2,3,4,4,4,3,2,1,1,1;2,3,4,4,3,2,1,1,1,1;}{2,2,2,2,2,2,2,2,2,2;3,3,2,2,2,2,2,2,2,2;4,4,3,3,3,2,2,2,2,2;4,4,4,4,4,3,2,2,2,2;3,3,4,4,4,4,3,2,2,2;1,2,3,3,4,4,4,3,2,2;1,1,1,2,3,4,4,3,2,2;1,1,1,2,2,3,4,4,3,2;1,1,1,1,2,2,3,4,4,3;1,1,1,1,1,2,3,4,4,3;}{2,2,5,2,2,2,2,2,2,2;2,5,5,2,2,2,2,2,2,3;2,5,5,2,2,2,3,3,3,4;5,5,2,2,2,3,4,4,4,4;2,5,2,2,3,4,4,4,4,3;5,2,5,3,4,4,4,3,3,1;2,5,3,4,4,4,3,2,2,1;2,5,3,4,4,3,2,2,1,1;2,3,4,4,4,3,2,1,1,1;2,3,4,4,3,2,1,1,1,1;}{2,2,2,2,2,2,2,2,2,2;3,3,2,2,2,2,2,2,2,2;4,4,3,3,3,2,2,2,2,2;4,4,4,4,4,3,2,2,2,2;3,3,4,4,4,4,3,2,2,2;1,2,3,3,4,4,4,3,2,2;1,1,1,2,3,4,4,3,2,2;1,1,1,2,2,3,4,4,3,2;1,1,1,1,2,2,3,4,4,3;1,1,1,1,1,2,3,4,4,3;}
{3,1,1,1,1,1,1,1,1,1;1,1,1,1,1,1,1,1,1,1;1,1,1,5,1,5,1,1,1,1;1,1,1,1,1,1,1,1,1,1;1,1,5,1,1,1,5,1,1,1;1,1,1,5,5,5,1,1,1,2;1,1,1,1,1,1,1,1,1,2;1,1,1,1,1,1,1,1,2,2;1,1,1,1,1,1,2,2,2,2;1,1,1,1,1,2,2,2,2,2;}{4,1,1,1,1,1,1,1,1,1;1,1,1,1,1,1,1,1,1,1;1,1,1,1,1,1,1,1,1,1;1,1,1,1,1,1,1,1,1,1;1,1,1,1,1,1,1,1,1,1;1,1,1,1,1,1,1,1,1,2;1,1,1,1,1,1,1,1,1,2;1,1,1,1,1,1,1,1,2,2;1,1,1,1,1,1,2,2,2,2;1,1,1,1,1,2,2,2,2,2;}{2,2,5,2,2,2,2,2,2,2;2,5,5,2,2,2,2,2,2,3;2,5,5,2,2,2,3,3,3,4;5,5,2,2,2,3,4,4,4,4;2,5,2,2,3,4,4,4,4,3;5,2,5,3,4,4,4,3,3,1;2,5,3,4,4,4,3,2,2,1;2,5,3,4,4,3,2,2,1,1;2,3,4,4,4,3,2,1,1,1;2,3,4,4,3,2,1,1,1,1;}{2,2,2,2,2,2,2,2,2,2;3,3,2,2,2,2,2,2,2,2;4,4,3,3,3,2,2,2,2,2;4,4,4,4,4,3,2,2,2,2;3,3,4,4,4,4,3,2,2,2;1,2,3,3,4,4,4,3,2,2;1,1,1,2,3,4,4,3,2,2;1,1,1,2,2,3,4,4,3,2;1,1,1,1,2,2,3,4,4,3;1,1,1,1,1,2,3,4,4,3;}{2,2,5,2,2,2,2,2,2,2;2,5,5,2,2,2,2,2,2,3;2,5,5,2,2,2,3,3,3,4;5,5,2,2,2,3,4,4,4,4;2,5,2,2,3,4,4,4,4,3;5,2,5,3,4,4,4,3,3,1;2,5,3,4,4,4,3,2,2,1;2,5,3,4,4,3,2,2,1,1;2,3,4,4,4,3,2,1,1,1;2,3,4,4,3,2,1,1,1,1;}{2,2,2,2,2,2,2,2,2,2;3,3,2,2,2,2,2,2,2,2;4,4,3,3,3,2,2,2,2,2;4,4,4,4,4,3,2,2,2,2;3,3,4,4,4,4,3,2,2,2;1,2,3,3,4,4,4,3,2,2;1,1,1,2,3,4,4,3,2,2;1,1,1,2,2,3,4,4,3,2;1,1,1,1,2,2,3,4,4,3;1,1,1,1,1,2,3,4,4,3;}
Oi im walkin here
This is the third line
This is NOT the third line
But the crimes thy kind have committed against humanity are NOT forgotten....
And thy punishment... is DEATH!
