{17,17,9,1,1,1,1,1,1,1;5,5,16,9,1,1,1,1,1,1;6,13,5,16,9,1,1,1,1,1;1,6,13,5,16,9,1,1,1,1;1,1,6,13,5,16,9,1,1,1;1,1,1,6,13,5,16,9,1,1;1,1,1,1,6,13,5,16,9,1;18,18,1,1,1,6,13,5,16,9;18,18,18,1,1,1,6,13,5,16;18,18,18,1,1,1,1,6,13,5;}{1,1,1,1,1,1,1,1,1,1;1,1,1,1,1,1,1,1,1,1;1,1,1,1,1,1,1,1,1,1;1,1,1,1,8,17,17,9,1,1;1,1,1,1,11,5,5,12,1,1;1,1,1,1,11,5,5,12,1,1;1,1,1,1,6,13,14,7,1,1;1,1,1,1,1,11,12,1,1,1;9,1,1,1,1,11,12,1,1,1;16,9,1,1,1,11,12,1,1,1;}{1,1,1,1,1,1,1,1,1,1;8,17,17,9,1,1,1,1,1,1;11,5,5,12,1,1,1,1,1,1;11,5,5,12,1,8,17,17,9,1;6,13,14,7,1,11,5,5,12,1;1,11,12,1,1,11,5,5,12,1;1,11,12,1,1,6,13,14,7,1;1,11,12,1,1,1,11,12,1,1;1,11,16,17,17,17,15,12,1,1;1,6,10,13,5,14,10,7,1,1;}{1,1,1,1,1,1,1,1,1,1;1,1,1,1,1,1,1,1,1,1;1,1,1,1,1,1,1,1,1,1;1,1,1,1,1,1,1,1,1,1;1,1,1,1,1,1,1,1,1,1;1,1,1,1,1,1,1,1,1,1;1,1,1,1,1,1,1,1,1,1;1,1,1,1,1,1,1,1,1,1;1,1,1,1,1,1,1,1,1,1;1,1,1,1,1,1,1,1,1,1;}{1,1,1,1,1,1,1,1,1,1;1,1,1,1,1,1,1,1,1,1;1,1,1,1,1,1,1,1,1,1;1,1,1,1,1,1,1,1,1,1;1,1,1,1,1,1,1,1,1,1;1,1,1,1,1,1,1,1,1,1;1,1,1,1,1,1,1,1,1,1;1,1,1,1,1,1,1,1,1,1;1,1,1,1,1,1,1,1,1,1;1,1,1,1,1,1,1,1,1,1;}{1,1,1,1,1,1,1,1,1,1;1,1,1,1,1,1,1,1,1,1;1,1,1,1,1,1,1,1,1,1;1,1,1,1,1,1,1,1,1,1;1,1,1,1,1,1,1,1,1,1;1,1,1,1,1,1,1,1,1,1;1,1,1,1,1,1,1,1,1,1;1,1,1,1,1,1,1,1,1,1;1,1,1,1,1,1,1,1,1,1;1,1,1,1,1,1,1,1,1,1;}{1,1,1,1,1,1,1,1,1,1;1,1,1,1,1,1,1,1,1,1;1,1,1,1,1,1,1,1,1,1;1,1,1,1,1,1,1,1,1,1;1,1,1,1,1,1,1,1,1,1;1,1,1,1,1,1,1,1,1,1;1,1,1,1,1,1,1,1,1,1;1,1,1,1,1,1,1,1,1,1;1,1,1,1,1,1,1,1,1,1;1,1,1,1,1,1,1,1,1,1;}{1,1,1,1,1,1,1,1,1,1;1,1,1,1,1,1,1,1,1,1;1,1,1,1,1,1,1,1,1,1;1,1,1,1,1,1,1,1,1,1;1,1,1,1,1,1,1,1,1,1;1,1,1,1,1,1,1,1,1,1;1,1,1,1,1,1,1,1,1,1;1,1,1,1,1,1,1,1,1,1;1,1,1,1,1,1,1,1,1,1;1,1,1,1,1,1,1,1,1,1;}{1,1,1,1,1,1,1,1,19,19;1,1,1,1,1,1,1,1,1,19;1,1,1,1,1,1,1,1,1,1;1,1,1,1,1,1,1,1,1,1;1,1,1,1,1,1,1,1,1,1;1,1,1,1,1,1,1,1,1,1;1,1,1,1,1,1,1,1,1,1;1,1,1,1,1,1,1,1,1,1;1,1,1,1,1,1,1,1,1,1;1,1,1,1,1,1,1,1,1,1;}
{18,18,18,1,1,1,1,1,6,13;18,1,1,1,1,1,1,1,1,6;1,1,1,1,1,1,1,1,1,1;1,1,1,1,1,1,1,1,1,1;1,1,1,1,1,1,1,1,1,1;1,1,1,1,1,1,1,1,1,1;1,1,1,1,1,1,1,1,1,1;1,1,1,1,1,1,1,1,1,1;1,1,1,1,1,1,1,1,1,1;1,1,1,1,1,1,1,1,1,1;}{5,16,9,1,1,11,12,1,1,1;13,5,16,9,1,11,12,1,1,1;6,13,5,16,9,11,12,1,1,1;1,6,13,5,16,15,16,17,17,17;1,1,6,13,5,5,5,5,5,5;1,1,1,6,13,14,10,10,10,10;1,1,1,1,11,12,1,1,1,1;1,1,1,1,11,12,1,1,1,1;1,1,1,1,11,12,1,1,1,1;1,1,1,1,11,12,1,1,1,1;}{1,1,1,11,5,12,1,1,1,1;1,1,1,11,5,12,1,1,1,1;1,1,1,11,5,12,1,1,1,1;17,17,17,15,5,16,17,17,17,17;5,5,5,5,5,5,5,5,5,5;10,10,10,10,10,10,10,10,10,10;1,1,1,1,1,1,1,1,1,1;1,1,1,1,1,1,1,1,1,1;1,1,1,1,1,1,1,1,1,1;1,1,1,1,1,1,1,1,1,1;}{1,1,1,1,1,1,1,1,1,1;1,1,8,17,17,17,17,9,1,1;1,8,15,5,5,5,5,16,9,1;17,15,14,10,10,10,13,5,16,17;5,5,12,1,1,1,6,13,5,5;10,10,7,1,1,1,1,6,10,10;1,1,1,1,1,1,1,1,1,1;1,1,1,1,1,1,1,1,1,1;1,1,1,1,1,1,1,1,1,1;1,1,1,1,1,1,1,1,1,1;}{1,1,1,1,1,1,1,1,1,1;1,1,1,1,1,1,1,1,1,1;1,1,1,1,1,1,1,1,1,1;17,17,17,17,9,1,1,1,1,1;5,5,5,5,16,9,1,1,1,1;10,10,10,10,13,16,9,1,1,1;1,1,1,1,6,13,16,17,17,17;1,1,1,1,1,6,13,5,5,5;1,1,1,1,1,1,6,10,10,10;1,1,1,1,1,1,1,1,1,1;}{1,1,1,1,1,1,1,1,1,1;1,1,1,8,17,17,17,9,1,1;1,1,1,11,5,5,5,12,1,1;1,1,1,11,5,5,5,12,1,1;1,1,1,6,13,5,14,7,1,1;1,1,1,1,11,5,12,1,1,1;17,17,17,17,15,5,12,1,1,1;5,5,5,5,5,5,12,1,1,1;10,10,10,13,5,5,12,1,1,1;1,1,1,11,5,5,12,1,1,1;}{1,1,1,1,1,1,1,1,1,1;1,1,1,1,1,1,1,1,1,1;1,1,1,1,1,1,1,1,1,1;1,1,1,1,1,1,1,1,1,1;1,1,1,1,1,1,1,1,1,1;1,1,1,1,1,1,1,1,1,1;1,1,1,1,1,1,1,1,1,1;1,1,1,1,1,1,1,1,1,1;1,1,1,1,1,1,1,1,1,1;1,1,1,1,1,1,1,1,1,1;}{1,1,1,1,1,1,1,1,1,1;1,1,1,1,1,1,1,1,1,1;1,1,1,1,1,1,1,1,1,1;1,1,1,1,1,1,1,1,1,1;1,1,1,1,1,1,1,1,1,1;1,1,1,1,1,1,1,1,1,1;1,1,1,1,1,1,1,1,1,1;1,1,1,1,1,1,1,1,1,1;1,1,1,1,1,1,1,1,1,1;1,1,1,1,1,1,1,1,1,1;}{1,1,1,1,1,1,1,1,1,1;1,1,1,1,1,1,1,1,1,1;1,1,1,1,1,1,1,1,1,1;1,1,1,1,1,1,1,1,1,1;1,1,1,1,1,1,1,1,1,1;1,1,1,1,1,1,1,1,1,1;1,1,1,1,1,1,1,1,1,1;1,1,1,1,1,1,1,1,1,1;1,1,1,1,1,1,1,1,1,1;1,1,1,1,1,1,1,1,1,1;}
{1,1,1,1,1,1,1,1,1,1;1,1,1,8,17,17,17,17,17,17;1,1,8,14,10,10,10,10,10,10;1,1,11,12,1,1,1,1,1,1;1,1,11,12,1,1,1,1,1,1;1,8,15,16,9,1,1,1,1,1;1,11,5,5,12,1,1,1,1,1;1,11,5,5,12,1,1,1,1,1;1,6,10,10,7,1,1,1,1,1;19,19,19,19,19,19,19,19,19,19;}{1,1,1,1,11,12,1,1,1,1;17,17,17,17,15,12,1,1,1,1;10,10,10,10,13,12,1,1,1,1;1,1,1,1,11,12,1,1,1,1;1,1,1,8,15,16,9,1,1,1;1,1,1,11,5,5,12,1,1,1;1,1,1,11,5,5,12,1,1,1;1,1,1,6,10,10,7,1,1,1;1,1,1,1,1,1,1,1,1,1;19,19,19,19,19,19,19,19,19,19;}{1,1,1,1,1,1,1,1,1,1;1,1,1,1,1,1,1,1,1,1;1,1,1,1,1,1,1,1,1,1;1,1,1,1,1,1,1,1,1,1;1,1,20,19,19,19,19,20,1,1;1,1,20,1,1,1,1,20,1,1;1,1,20,1,8,9,1,20,1,1;1,1,20,1,11,12,1,20,1,1;1,1,20,1,11,12,1,20,1,1;19,19,20,1,11,12,1,20,19,19;}{1,1,1,1,1,1,1,1,1,1;1,1,1,1,1,1,1,1,1,1;1,1,1,1,1,1,1,1,1,1;1,1,1,1,1,1,1,1,1,1;1,1,1,1,1,1,1,1,1,1;1,1,1,1,1,1,1,1,1,1;1,1,1,1,1,1,1,1,1,1;1,1,1,1,1,1,1,1,1,1;1,1,1,1,1,1,1,1,1,1;19,19,19,19,19,19,19,19,19,19;}{1,1,1,1,1,1,1,1,1,1;1,1,1,1,1,1,1,1,1,1;1,1,1,1,1,1,1,1,1,1;1,1,1,1,1,1,1,1,1,1;1,1,1,1,1,1,1,1,1,1;1,1,1,1,1,1,1,1,1,1;1,1,1,1,1,1,1,1,1,1;1,1,1,1,1,1,1,1,1,1;1,1,1,1,1,1,1,1,1,1;19,19,19,19,1,1,1,1,1,1;}{1,1,1,11,5,5,12,1,1,1;1,1,1,11,5,5,12,1,1,1;1,1,1,11,5,5,12,1,1,1;1,1,1,11,5,5,12,1,1,1;1,1,1,11,5,5,12,1,1,1;1,1,1,11,5,5,12,1,1,1;1,1,1,11,5,5,12,1,1,1;1,1,1,11,5,5,12,1,1,1;1,1,1,11,5,5,12,1,1,1;19,1,1,11,5,5,12,1,1,1;}{1,1,1,1,1,1,1,1,1,1;1,1,1,1,1,1,1,1,1,1;1,1,1,1,1,1,1,1,1,1;1,1,1,1,1,1,1,1,1,1;1,1,1,1,1,1,1,1,1,1;1,1,1,1,1,1,1,1,1,1;1,1,1,1,1,1,1,1,1,1;1,1,1,1,1,1,1,1,1,1;1,1,1,1,1,1,1,1,1,1;1,1,1,1,1,1,1,1,1,1;}{1,1,1,1,1,1,1,1,1,1;1,1,1,1,1,1,1,1,1,1;1,1,1,1,1,1,1,1,1,1;1,1,1,1,1,1,1,1,1,1;1,1,1,1,1,1,1,1,1,1;1,1,1,1,1,1,1,1,1,1;1,1,1,1,1,1,1,1,1,1;1,1,1,1,1,1,1,1,1,1;1,1,1,1,1,1,1,1,1,1;1,1,1,1,1,1,1,1,1,1;}{1,1,1,1,1,1,1,1,1,1;1,1,1,1,1,1,1,1,1,1;1,1,1,1,1,1,1,1,1,1;1,1,1,1,1,1,1,1,1,1;1,1,1,1,1,1,1,1,1,1;1,1,1,1,1,1,1,1,1,1;1,1,1,1,1,1,1,1,1,1;1,1,1,1,1,1,1,1,1,1;1,1,1,1,1,1,1,1,1,1;1,1,1,1,1,1,1,1,1,1;}
{1,1,1,1,1,1,1,1,1,1;1,1,1,1,1,1,1,1,1,1;1,1,1,1,1,1,1,1,1,1;1,1,1,1,1,1,1,1,1,1;1,1,1,1,1,1,1,1,1,1;1,1,1,1,1,1,1,1,1,1;1,1,1,1,1,1,1,1,1,1;1,1,1,1,1,1,1,1,1,1;1,1,1,1,1,1,1,1,1,1;1,1,1,1,1,1,1,1,1,1;}{1,1,1,1,1,1,1,1,1,1;1,1,1,1,1,1,1,1,1,1;1,1,1,1,1,1,1,1,1,1;1,1,1,1,1,1,1,1,1,1;1,1,1,1,1,1,1,1,1,1;1,1,1,1,1,1,1,1,1,1;1,1,1,1,1,1,1,1,1,1;1,1,1,1,1,1,1,1,1,1;1,1,1,1,1,1,1,1,1,1;1,1,1,1,1,1,1,1,1,1;}{1,1,1,1,11,12,1,1,20,18;1,1,1,1,11,12,1,1,20,18;1,1,1,1,6,16,9,1,20,18;1,1,1,1,1,6,16,9,20,18;1,1,1,1,1,1,11,12,20,18;1,1,1,1,1,1,11,12,20,18;1,1,1,1,1,1,11,12,20,18;1,1,1,1,1,8,15,7,20,18;1,1,1,1,8,15,7,1,20,18;1,1,1,1,11,12,1,1,20,18;}{18,18,18,18,18,18,18,18,18,18;18,18,18,18,18,18,18,18,18,18;18,18,18,18,18,18,18,18,18,18;18,18,18,18,18,18,18,18,18,18;18,18,18,18,18,18,18,18,18,18;18,18,18,18,18,18,18,18,18,18;18,18,18,18,18,18,18,18,18,18;18,18,18,18,18,18,18,18,18,18;18,18,18,18,18,18,18,18,18,18;18,18,18,18,18,18,18,18,18,18;}{18,18,18,20,20,1,1,1,1,1;18,18,18,18,20,1,1,1,1,1;18,18,18,18,20,1,1,1,1,1;18,18,18,18,20,1,1,1,1,1;18,18,18,18,20,1,1,1,1,1;18,18,18,18,20,1,1,1,1,1;18,18,18,18,20,1,1,1,1,1;18,18,18,18,20,1,1,1,1,1;18,18,18,18,20,1,1,1,1,1;18,18,18,18,20,1,1,1,1,1;}{1,1,1,11,5,5,12,1,1,1;1,1,1,11,5,5,12,1,1,1;1,1,1,11,5,5,12,1,1,1;1,1,1,11,5,5,12,1,1,1;1,1,1,11,5,5,12,1,1,1;1,1,1,11,5,5,12,1,1,1;1,1,1,11,5,5,12,1,1,1;1,1,8,15,5,5,16,9,1,1;1,8,15,5,5,5,5,16,9,1;1,11,5,5,5,5,5,5,12,1;}{1,1,1,1,1,1,1,1,1,1;1,1,1,1,1,1,1,1,1,1;1,1,1,1,1,1,1,1,1,1;1,1,1,1,1,1,1,1,1,1;1,1,1,1,1,1,1,1,1,1;1,1,1,1,1,1,1,1,1,1;1,1,1,1,1,1,1,1,1,1;1,1,1,1,1,1,1,1,1,1;1,1,1,1,1,1,1,1,1,1;1,1,1,1,1,1,1,1,1,1;}{1,1,1,1,1,1,1,1,1,1;1,1,1,1,1,1,1,1,1,1;1,1,1,1,1,1,1,1,1,1;1,1,1,1,1,1,1,1,1,1;1,1,1,1,1,1,1,1,1,1;1,1,1,1,1,1,1,1,1,1;1,1,1,1,1,1,1,1,1,1;1,1,1,1,1,1,1,1,1,1;1,1,1,1,1,1,1,1,1,1;1,1,1,1,1,1,1,1,1,1;}{1,1,1,1,1,1,1,1,1,1;1,1,1,1,1,1,1,1,1,1;1,1,1,1,1,1,1,1,1,1;1,1,1,1,1,1,1,1,1,1;1,1,1,1,1,1,1,1,1,1;1,1,1,1,1,1,1,1,1,1;1,1,1,1,1,1,1,1,1,1;1,1,1,1,1,1,1,1,1,1;1,1,1,1,1,1,1,1,1,1;1,1,1,1,1,1,1,1,1,1;}
{18,8,17,17,17,17,17,17,9,1;18,11,5,5,5,5,5,5,16,17;18,6,10,10,10,10,10,10,10,10;1,1,1,1,1,1,1,1,1,1;1,1,1,1,1,1,1,1,1,1;1,1,1,1,1,1,1,1,1,1;1,1,1,1,1,1,1,1,1,1;1,1,1,1,1,1,1,1,1,1;1,1,1,1,1,1,1,1,1,1;1,1,1,1,1,1,1,1,1,1;}{1,1,1,1,1,1,1,1,1,1;17,9,1,1,1,1,1,1,8,17;13,12,1,1,1,1,1,1,11,14;11,16,17,17,17,17,17,17,15,12;11,5,5,5,5,5,5,5,5,12;11,5,5,5,5,5,5,5,5,12;11,5,5,5,5,5,5,5,5,12;11,5,5,5,5,5,5,5,5,12;11,5,5,5,5,5,5,5,5,12;11,5,5,5,5,5,5,5,5,12;}{1,1,1,1,11,12,1,1,20,18;17,17,17,17,15,16,17,17,17,9;10,10,10,10,10,10,10,10,10,7;1,1,1,1,1,1,1,1,20,18;1,1,1,1,1,1,1,1,20,18;1,1,1,1,1,1,1,1,20,18;1,1,1,1,1,1,1,1,20,18;1,1,1,1,1,1,1,1,20,18;1,1,1,1,1,1,1,1,20,18;1,1,1,1,1,1,1,1,20,18;}{18,18,18,18,18,18,18,18,18,18;18,18,18,18,18,18,18,18,18,18;18,18,18,18,18,18,18,18,18,18;18,18,18,18,18,18,18,18,18,18;18,18,18,18,18,18,18,18,18,18;18,18,18,18,18,18,18,18,18,18;18,18,18,18,18,18,18,18,18,18;18,18,18,18,18,18,18,18,18,18;18,18,18,18,18,18,18,18,18,18;18,18,18,18,18,18,18,18,18,18;}{18,18,18,18,20,1,1,1,1,1;18,18,18,18,20,1,1,1,1,1;18,18,18,18,20,1,1,1,1,1;18,18,18,18,20,1,1,1,1,1;18,18,18,18,20,1,1,1,1,1;18,18,18,18,20,1,1,1,1,1;18,18,18,18,20,1,1,1,1,1;18,18,18,18,20,1,1,1,1,1;18,18,18,18,20,1,1,1,1,1;18,18,18,18,20,1,1,1,1,1;}{1,11,5,5,5,5,5,5,12,1;1,11,5,5,5,5,5,5,12,1;1,11,5,5,5,5,5,5,12,1;1,11,5,5,5,5,5,5,12,1;1,11,5,5,5,5,5,5,12,1;1,11,5,5,5,5,5,5,12,1;1,11,5,5,5,5,5,5,12,1;1,6,13,5,5,5,5,14,7,1;1,1,6,13,5,5,14,7,1,1;1,1,1,6,13,14,7,1,1,1;}{1,1,1,1,1,1,1,1,1,1;1,1,1,1,1,1,1,1,1,1;1,1,1,1,1,1,1,1,1,1;1,1,1,1,1,1,1,1,1,1;1,1,1,1,1,1,1,1,1,1;1,1,1,1,1,1,1,1,1,1;1,1,1,1,1,1,1,1,1,1;1,1,1,1,1,1,1,1,1,1;1,1,1,1,1,1,1,1,1,1;1,1,1,1,1,1,1,1,1,1;}{1,1,1,1,1,1,1,1,1,1;1,1,1,1,1,1,1,1,1,1;1,1,1,1,1,1,1,1,1,1;1,1,1,1,1,1,1,1,1,1;1,1,1,1,1,1,1,1,1,1;1,1,1,1,1,1,1,1,1,1;1,1,1,1,1,1,1,1,1,1;1,1,1,1,1,1,1,1,1,1;1,1,1,1,1,1,1,1,1,1;1,1,1,1,1,1,1,1,1,1;}{1,1,1,1,1,1,1,1,1,1;1,1,1,1,1,1,1,1,1,1;1,1,1,1,1,1,1,1,1,1;1,1,1,1,1,1,1,1,1,1;1,1,1,1,1,1,1,1,1,1;1,1,1,1,1,1,1,1,1,1;1,1,1,1,1,1,1,1,1,1;1,1,1,1,1,1,1,1,1,1;1,1,1,1,1,1,1,1,1,1;1,1,1,1,1,1,1,1,1,1;}
{1,1,1,1,1,1,1,1,1,1;1,1,1,1,1,1,1,1,1,1;1,1,1,1,1,1,1,1,1,1;1,1,1,1,1,1,1,1,1,1;1,1,1,1,1,1,1,1,1,1;1,1,1,1,1,1,1,1,1,1;1,1,1,1,1,1,1,1,1,1;1,1,1,1,1,1,1,1,1,1;1,1,1,1,1,1,1,1,1,1;1,1,1,1,1,1,1,1,1,1;}{11,5,5,5,5,5,5,5,5,12;11,5,5,5,5,5,5,5,5,12;6,10,10,10,10,10,10,10,10,7;1,1,1,1,1,1,1,1,1,1;1,1,1,1,1,1,1,1,1,1;1,1,1,1,1,1,1,1,1,1;1,1,1,1,1,1,1,1,1,1;1,1,1,1,1,1,1,1,1,1;1,1,1,1,1,1,1,1,1,1;1,1,1,1,1,1,1,1,1,1;}{1,1,1,1,1,1,1,1,20,18;1,1,1,1,1,1,1,1,20,18;1,1,1,1,1,1,1,1,20,18;1,1,1,1,1,1,1,1,20,18;1,1,1,1,1,1,1,1,20,18;1,1,1,1,1,1,1,1,20,18;1,1,1,1,1,1,1,1,20,18;1,1,1,1,1,1,1,1,20,18;1,1,1,1,1,1,1,1,20,20;1,1,1,1,1,1,1,1,1,19;}{18,18,18,18,18,18,18,18,18,18;18,18,18,18,18,18,18,18,18,18;18,18,18,18,18,18,18,18,18,18;18,18,18,18,18,18,18,18,18,18;18,18,18,18,18,18,18,18,18,18;18,18,18,18,18,18,18,18,18,18;18,18,18,18,18,18,18,18,18,18;18,18,18,18,18,18,18,18,18,18;18,18,18,18,18,18,18,18,18,18;19,19,19,19,19,19,19,19,19,19;}{18,18,18,18,20,1,1,1,1,1;18,18,18,18,20,1,1,1,1,1;18,18,18,18,20,1,1,1,1,1;18,18,18,8,17,17,17,17,17,17;18,18,18,6,10,10,10,10,10,10;18,18,18,18,20,1,1,1,1,1;18,18,18,18,20,1,1,1,1,1;18,18,18,20,20,1,1,1,1,1;18,18,20,20,1,1,1,1,1,1;19,19,20,1,1,1,1,1,1,1;}{1,1,1,1,11,12,1,1,1,1;1,1,1,1,11,12,1,1,1,1;1,1,1,1,11,12,1,1,1,1;17,17,17,17,15,12,1,1,1,1;10,10,10,10,10,7,1,1,1,1;1,1,1,1,1,1,1,1,1,1;1,1,1,1,1,1,1,1,1,1;1,1,1,1,1,1,1,1,1,1;1,1,1,1,1,1,1,1,1,1;1,1,1,1,1,1,1,1,1,1;}{1,1,1,1,1,1,1,1,1,1;1,1,1,1,1,1,1,1,1,1;1,1,1,1,1,1,1,1,1,1;1,1,1,1,1,1,1,1,1,1;1,1,1,1,1,1,1,1,1,1;1,1,1,1,1,1,1,1,1,1;1,1,1,1,1,1,1,1,1,1;1,1,1,1,1,1,1,1,1,1;1,1,1,1,1,1,1,1,1,1;1,1,1,1,1,1,1,1,1,1;}{1,1,1,1,1,1,1,1,1,1;1,1,1,1,1,1,1,1,1,1;1,1,1,1,1,1,1,1,1,1;1,1,1,1,1,1,1,1,1,1;1,1,1,1,1,1,1,1,1,1;1,1,1,1,1,1,1,1,1,1;1,1,1,1,1,1,1,1,1,1;1,1,1,1,1,1,1,1,1,1;1,1,1,1,1,1,1,1,1,1;1,1,1,1,1,1,1,1,1,1;}{1,1,1,1,1,1,1,1,1,1;1,1,1,1,1,1,1,1,1,1;1,1,1,1,1,1,1,1,1,1;1,1,1,1,1,1,1,1,1,1;1,1,1,1,1,1,1,1,1,1;1,1,1,1,1,1,1,1,1,1;1,1,1,1,1,1,1,1,1,1;1,1,1,1,1,1,1,1,1,1;1,1,1,1,1,1,1,1,1,1;1,1,1,1,1,1,1,1,1,1;}
{1,1,1,1,1,1,1,1,1,1;1,1,1,1,1,1,1,1,1,1;1,1,1,1,1,1,1,1,1,1;1,1,1,1,1,1,1,1,1,1;1,1,1,1,1,1,1,1,1,1;1,1,1,1,1,1,1,1,1,1;1,1,1,1,1,1,1,1,1,1;1,1,1,1,1,1,1,1,1,1;1,1,1,1,1,1,1,1,1,1;1,1,1,1,1,1,1,1,1,1;}{1,1,1,1,1,1,1,1,1,1;1,1,1,1,1,1,1,1,1,1;1,1,1,1,1,1,1,1,1,1;1,1,1,1,1,1,1,1,1,1;1,1,1,1,1,1,1,1,1,1;1,1,1,1,1,1,1,1,1,1;1,1,1,1,1,1,1,1,1,1;1,1,1,1,1,1,1,1,1,1;1,1,1,1,1,1,1,1,1,1;1,1,1,1,1,1,1,1,1,1;}{1,1,1,1,1,1,1,1,1,1;1,1,1,1,1,1,1,1,1,1;1,1,1,1,1,1,1,1,1,1;1,1,1,1,1,1,1,1,1,1;1,1,1,1,1,1,1,1,1,1;1,1,1,1,1,1,1,1,1,1;1,1,1,1,1,1,1,1,1,1;1,1,1,1,1,1,1,1,1,1;1,1,1,1,1,1,1,1,1,1;1,1,1,1,1,1,1,1,1,1;}{1,1,1,1,1,1,1,1,1,1;1,1,1,1,1,1,1,1,1,1;1,1,1,1,1,1,1,1,1,1;1,1,1,1,1,1,1,1,1,1;1,1,1,1,1,1,1,1,1,1;1,1,1,1,1,1,1,1,1,1;1,1,1,1,1,1,1,1,1,1;1,1,1,1,1,1,1,1,1,1;1,1,1,1,1,1,1,1,1,1;1,1,1,1,1,1,1,1,1,1;}{1,1,1,1,1,1,1,1,1,1;1,1,1,1,1,1,1,1,1,1;1,1,1,1,1,1,1,1,1,1;1,1,1,1,1,1,1,1,1,1;1,1,1,1,1,1,1,1,1,1;1,1,1,1,1,1,1,1,1,1;1,1,1,1,1,1,1,1,1,1;1,1,1,1,1,1,1,1,1,1;1,1,1,1,1,1,1,1,1,1;1,1,1,1,1,1,1,1,1,1;}{1,1,1,1,1,1,1,1,1,1;1,1,1,1,1,1,1,1,1,1;1,1,1,1,1,1,1,1,1,1;1,1,1,1,1,1,1,1,1,1;1,1,1,1,1,1,1,1,1,1;1,1,1,1,1,1,1,1,1,1;1,1,1,1,1,1,1,1,1,1;1,1,1,1,1,1,1,1,1,1;1,1,1,1,1,1,1,1,1,1;1,1,1,1,1,1,1,1,1,1;}{1,1,1,1,1,1,1,1,1,1;1,1,1,1,1,1,1,1,1,1;1,1,1,1,1,1,1,1,1,1;1,1,1,1,1,1,1,1,1,1;1,1,1,1,1,1,1,1,1,1;1,1,1,1,1,1,1,1,1,1;1,1,1,1,1,1,1,1,1,1;1,1,1,1,1,1,1,1,1,1;1,1,1,1,1,1,1,1,1,1;1,1,1,1,1,1,1,1,1,1;}{1,1,1,1,1,1,1,1,1,1;1,1,1,1,1,1,1,1,1,1;1,1,1,1,1,1,1,1,1,1;1,1,1,1,1,1,1,1,1,1;1,1,1,1,1,1,1,1,1,1;1,1,1,1,1,1,1,1,1,1;1,1,1,1,1,1,1,1,1,1;1,1,1,1,1,1,1,1,1,1;1,1,1,1,1,1,1,1,1,1;1,1,1,1,1,1,1,1,1,1;}{1,1,1,1,1,1,1,1,1,1;1,1,1,1,1,1,1,1,1,1;1,1,1,1,1,1,1,1,1,1;1,1,1,1,1,1,1,1,1,1;1,1,1,1,1,1,1,1,1,1;1,1,1,1,1,1,1,1,1,1;1,1,1,1,1,1,1,1,1,1;1,1,1,1,1,1,1,1,1,1;1,1,1,1,1,1,1,1,1,1;1,1,1,1,1,1,1,1,1,1;}
Oi im walkin here
This is the third line
This is NOT the third line
And thy punishment... is DEATH!