{4,4,4,4,4,4,4,4,4,8;4,4,4,4,4,4,8,17,17,15;4,4,4,4,4,8,15,5,14,10;4,4,4,4,8,15,14,10,7,4;4,4,4,4,11,14,7,4,4,4;4,4,4,8,15,12,4,4,4,4;4,4,8,15,14,7,4,4,4,4;4,8,15,14,7,4,4,4,4,4;4,11,14,7,4,4,4,4,4,4;8,15,12,4,4,4,4,4,4,4;}{2,2,2,2,2,2,2,2,2,2;3,3,2,2,2,2,2,2,2,2;4,4,3,3,3,2,2,2,2,2;4,4,4,4,4,3,2,2,2,2;3,3,4,4,4,4,3,2,2,2;1,2,3,3,4,4,4,3,2,2;1,1,1,2,3,4,4,3,2,2;1,1,1,2,2,3,4,4,3,2;1,1,1,1,2,2,3,4,4,3;1,1,1,1,1,2,3,4,4,3;}{2,2,5,2,2,2,2,2,2,2;2,5,5,2,2,2,2,2,2,3;2,5,5,2,2,2,3,3,3,4;5,5,2,2,2,3,4,4,4,4;2,5,2,2,3,4,4,4,4,3;5,2,5,3,4,4,4,3,3,1;2,5,3,4,4,4,3,2,2,1;2,5,3,4,4,3,2,2,1,1;2,3,4,4,4,3,2,1,1,1;2,3,4,4,3,2,1,1,1,1;}{2,2,2,2,2,2,2,2,2,2;3,3,2,2,2,2,2,2,2,2;4,4,3,3,3,2,2,2,2,2;4,4,4,4,4,3,2,2,2,2;3,3,4,4,4,4,3,2,2,2;1,2,3,3,4,4,4,3,2,2;1,1,1,2,3,4,4,3,2,2;1,1,1,2,2,3,4,4,3,2;1,1,1,1,2,2,3,4,4,3;1,1,1,1,1,2,3,4,4,3;}{2,2,5,2,2,2,2,2,2,2;2,5,5,2,2,2,2,2,2,3;2,5,5,2,2,2,3,3,3,4;5,5,2,2,2,3,4,4,4,4;2,5,2,2,3,4,4,4,4,3;5,2,5,3,4,4,4,3,3,1;2,5,3,4,4,4,3,2,2,1;2,5,3,4,4,3,2,2,1,1;2,3,4,4,4,3,2,1,1,1;2,3,4,4,3,2,1,1,1,1;}{2,2,2,2,2,2,2,2,2,2;3,3,2,2,2,2,2,2,2,2;4,4,3,3,3,2,2,2,2,2;4,4,4,4,4,3,2,2,2,2;3,3,4,4,4,4,3,2,2,2;1,2,3,3,4,4,4,3,2,2;1,1,1,2,3,4,4,3,2,2;1,1,1,2,2,3,4,4,3,2;1,1,1,1,2,2,3,4,4,3;1,1,1,1,1,2,3,4,4,3;}
{2,3,4,4,3,2,1,1,1,1;2,2,3,4,4,3,2,1,1,1;2,2,3,4,4,4,3,1,1,1;2,2,2,3,4,4,4,3,2,1;2,2,5,3,4,4,4,3,2,2;2,2,3,4,4,4,4,3,2,2;2,3,4,4,4,3,3,2,2,2;3,4,4,4,3,2,2,2,2,2;3,4,4,3,2,2,2,2,2,2;3,4,4,3,2,2,2,2,2,2;}{1,1,1,1,1,2,3,4,4,3;1,1,1,1,2,2,3,4,4,4;1,1,1,2,2,2,2,3,4,4;1,2,2,2,2,2,2,3,4,4;2,2,2,2,2,2,2,3,4,4;2,2,2,2,2,2,2,2,3,4;2,2,2,2,2,2,2,2,2,3;2,2,2,2,2,2,2,2,2,2;2,2,2,2,2,2,2,2,2,2;2,2,2,2,2,2,2,2,2,2;}{2,2,5,2,2,2,2,2,2,2;2,5,5,2,2,2,2,2,2,3;2,5,5,2,2,2,3,3,3,4;5,5,2,2,2,3,4,4,4,4;2,5,2,2,3,4,4,4,4,3;5,2,5,3,4,4,4,3,3,1;2,5,3,4,4,4,3,2,2,1;2,5,3,4,4,3,2,2,1,1;2,3,4,4,4,3,2,1,1,1;2,3,4,4,3,2,1,1,1,1;}{2,2,2,2,2,2,2,2,2,2;3,3,2,2,2,2,2,2,2,2;4,4,3,3,3,2,2,2,2,2;4,4,4,4,4,3,2,2,2,2;3,3,4,4,4,4,3,2,2,2;1,2,3,3,4,4,4,3,2,2;1,1,1,2,3,4,4,3,2,2;1,1,1,2,2,3,4,4,3,2;1,1,1,1,2,2,3,4,4,3;1,1,1,1,1,2,3,4,4,3;}{2,2,5,2,2,2,2,2,2,2;2,5,5,2,2,2,2,2,2,3;2,5,5,2,2,2,3,3,3,4;5,5,2,2,2,3,4,4,4,4;2,5,2,2,3,4,4,4,4,3;5,2,5,3,4,4,4,3,3,1;2,5,3,4,4,4,3,2,2,1;2,5,3,4,4,3,2,2,1,1;2,3,4,4,4,3,2,1,1,1;2,3,4,4,3,2,1,1,1,1;}{2,2,2,2,2,2,2,2,2,2;3,3,2,2,2,2,2,2,2,2;4,4,3,3,3,2,2,2,2,2;4,4,4,4,4,3,2,2,2,2;3,3,4,4,4,4,3,2,2,2;1,2,3,3,4,4,4,3,2,2;1,1,1,2,3,4,4,3,2,2;1,1,1,2,2,3,4,4,3,2;1,1,1,1,2,2,3,4,4,3;1,1,1,1,1,2,3,4,4,3;}
{3,1,1,1,1,1,1,1,1,1;1,1,1,1,1,1,1,1,1,1;1,1,1,5,1,5,1,1,1,1;1,1,1,1,1,1,1,1,1,1;1,1,5,1,1,1,5,1,1,1;1,1,1,5,5,5,1,1,1,2;1,1,1,1,1,1,1,1,1,2;1,1,1,1,1,1,1,1,2,2;1,1,1,1,1,1,2,2,2,2;1,1,1,1,1,2,2,2,2,2;}{4,1,1,1,1,1,1,1,1,1;1,1,1,1,1,1,1,1,1,1;1,1,1,1,1,1,1,1,1,1;1,1,1,1,1,1,1,1,1,1;1,1,1,1,1,1,1,1,1,1;1,1,1,1,1,1,1,1,1,2;1,1,1,1,1,1,1,1,1,2;1,1,1,1,1,1,1,1,2,2;1,1,1,1,1,1,2,2,2,2;1,1,1,1,1,2,2,2,2,2;}{2,2,5,2,2,2,2,2,2,2;2,5,5,2,2,2,2,2,2,3;2,5,5,2,2,2,3,3,3,4;5,5,2,2,2,3,4,4,4,4;2,5,2,2,3,4,4,4,4,3;5,2,5,3,4,4,4,3,3,1;2,5,3,4,4,4,3,2,2,1;2,5,3,4,4,3,2,2,1,1;2,3,4,4,4,3,2,1,1,1;2,3,4,4,3,2,1,1,1,1;}{2,2,2,2,2,2,2,2,2,2;3,3,2,2,2,2,2,2,2,2;4,4,3,3,3,2,2,2,2,2;4,4,4,4,4,3,2,2,2,2;3,3,4,4,4,4,3,2,2,2;1,2,3,3,4,4,4,3,2,2;1,1,1,2,3,4,4,3,2,2;1,1,1,2,2,3,4,4,3,2;1,1,1,1,2,2,3,4,4,3;1,1,1,1,1,2,3,4,4,3;}{2,2,5,2,2,2,2,2,2,2;2,5,5,2,2,2,2,2,2,3;2,5,5,2,2,2,3,3,3,4;5,5,2,2,2,3,4,4,4,4;2,5,2,2,3,4,4,4,4,3;5,2,5,3,4,4,4,3,3,1;2,5,3,4,4,4,3,2,2,1;2,5,3,4,4,3,2,2,1,1;2,3,4,4,4,3,2,1,1,1;2,3,4,4,3,2,1,1,1,1;}{2,2,2,2,2,2,2,2,2,2;3,3,2,2,2,2,2,2,2,2;4,4,3,3,3,2,2,2,2,2;4,4,4,4,4,3,2,2,2,2;3,3,4,4,4,4,3,2,2,2;1,2,3,3,4,4,4,3,2,2;1,1,1,2,3,4,4,3,2,2;1,1,1,2,2,3,4,4,3,2;1,1,1,1,2,2,3,4,4,3;1,1,1,1,1,2,3,4,4,3;}
{3,1,1,1,1,1,1,1,1,1;1,1,1,1,1,1,1,1,1,1;1,1,1,5,1,5,1,1,1,1;1,1,1,1,1,1,1,1,1,1;1,1,5,1,1,1,5,1,1,1;1,1,1,5,5,5,1,1,1,2;1,1,1,1,1,1,1,1,1,2;1,1,1,1,1,1,1,1,2,2;1,1,1,1,1,1,2,2,2,2;1,1,1,1,1,2,2,2,2,2;}{4,1,1,1,1,1,1,1,1,1;1,1,1,1,1,1,1,1,1,1;1,1,1,1,1,1,1,1,1,1;1,1,1,1,1,1,1,1,1,1;1,1,1,1,1,1,1,1,1,1;1,1,1,1,1,1,1,1,1,2;1,1,1,1,1,1,1,1,1,2;1,1,1,1,1,1,1,1,2,2;1,1,1,1,1,1,2,2,2,2;1,1,1,1,1,2,2,2,2,2;}{2,2,5,2,2,2,2,2,2,2;2,5,5,2,2,2,2,2,2,3;2,5,5,2,2,2,3,3,3,4;5,5,2,2,2,3,4,4,4,4;2,5,2,2,3,4,4,4,4,3;5,2,5,3,4,4,4,3,3,1;2,5,3,4,4,4,3,2,2,1;2,5,3,4,4,3,2,2,1,1;2,3,4,4,4,3,2,1,1,1;2,3,4,4,3,2,1,1,1,1;}{2,2,2,2,2,2,2,2,2,2;3,3,2,2,2,2,2,2,2,2;4,4,3,3,3,2,2,2,2,2;4,4,4,4,4,3,2,2,2,2;3,3,4,4,4,4,3,2,2,2;1,2,3,3,4,4,4,3,2,2;1,1,1,2,3,4,4,3,2,2;1,1,1,2,2,3,4,4,3,2;1,1,1,1,2,2,3,4,4,3;1,1,1,1,1,2,3,4,4,3;}{2,2,5,2,2,2,2,2,2,2;2,5,5,2,2,2,2,2,2,3;2,5,5,2,2,2,3,3,3,4;5,5,2,2,2,3,4,4,4,4;2,5,2,2,3,4,4,4,4,3;5,2,5,3,4,4,4,3,3,1;2,5,3,4,4,4,3,2,2,1;2,5,3,4,4,3,2,2,1,1;2,3,4,4,4,3,2,1,1,1;2,3,4,4,3,2,1,1,1,1;}{2,2,2,2,2,2,2,2,2,2;3,3,2,2,2,2,2,2,2,2;4,4,3,3,3,2,2,2,2,2;4,4,4,4,4,3,2,2,2,2;3,3,4,4,4,4,3,2,2,2;1,2,3,3,4,4,4,3,2,2;1,1,1,2,3,4,4,3,2,2;1,1,1,2,2,3,4,4,3,2;1,1,1,1,2,2,3,4,4,3;1,1,1,1,1,2,3,4,4,3;}
{3,1,1,1,1,1,1,1,1,1;1,1,1,1,1,1,1,1,1,1;1,1,1,5,1,5,1,1,1,1;1,1,1,1,1,1,1,1,1,1;1,1,5,1,1,1,5,1,1,1;1,1,1,5,5,5,1,1,1,2;1,1,1,1,1,1,1,1,1,2;1,1,1,1,1,1,1,1,2,2;1,1,1,1,1,1,2,2,2,2;1,1,1,1,1,2,2,2,2,2;}{4,1,1,1,1,1,1,1,1,1;1,1,1,1,1,1,1,1,1,1;1,1,1,1,1,1,1,1,1,1;1,1,1,1,1,1,1,1,1,1;1,1,1,1,1,1,1,1,1,1;1,1,1,1,1,1,1,1,1,2;1,1,1,1,1,1,1,1,1,2;1,1,1,1,1,1,1,1,2,2;1,1,1,1,1,1,2,2,2,2;1,1,1,1,1,2,2,2,2,2;}{2,2,5,2,2,2,2,2,2,2;2,5,5,2,2,2,2,2,2,3;2,5,5,2,2,2,3,3,3,4;5,5,2,2,2,3,4,4,4,4;2,5,2,2,3,4,4,4,4,3;5,2,5,3,4,4,4,3,3,1;2,5,3,4,4,4,3,2,2,1;2,5,3,4,4,3,2,2,1,1;2,3,4,4,4,3,2,1,1,1;2,3,4,4,3,2,1,1,1,1;}{2,2,2,2,2,2,2,2,2,2;3,3,2,2,2,2,2,2,2,2;4,4,3,3,3,2,2,2,2,2;4,4,4,4,4,3,2,2,2,2;3,3,4,4,4,4,3,2,2,2;1,2,3,3,4,4,4,3,2,2;1,1,1,2,3,4,4,3,2,2;1,1,1,2,2,3,4,4,3,2;1,1,1,1,2,2,3,4,4,3;1,1,1,1,1,2,3,4,4,3;}{2,2,2,2,2,2,2,2,2,2;2,2,2,2,2,2,2,2,2,2;2,2,2,2,2,2,2,2,2,2;2,2,2,2,2,2,2,2,2,2;2,2,2,2,2,2,2,2,2,2;2,2,2,2,2,2,2,2,2,2;2,2,2,2,2,2,2,2,2,2;2,2,2,2,2,2,2,2,2,2;2,2,2,2,2,2,2,2,2,2;2,2,2,2,2,2,2,2,2,2;}{2,2,2,2,2,2,2,2,2,2;3,3,2,2,2,2,2,2,2,2;4,4,3,3,3,2,2,2,2,2;4,4,4,4,4,3,2,2,2,2;3,3,4,4,4,4,3,2,2,2;1,2,3,3,4,4,4,3,2,2;1,1,1,2,3,4,4,3,2,2;1,1,1,2,2,3,4,4,3,2;1,1,1,1,2,2,3,4,4,3;1,1,1,1,1,2,3,4,4,3;}
{3,1,1,1,1,1,1,1,1,1;1,1,1,1,1,1,1,1,1,1;1,1,1,5,1,5,1,1,1,1;1,1,1,1,1,1,1,1,1,1;1,1,5,1,1,1,5,1,1,1;1,1,1,5,5,5,1,1,1,2;1,1,1,1,1,1,1,1,1,2;1,1,1,1,1,1,1,1,2,2;1,1,1,1,1,1,2,2,2,2;1,1,1,1,1,2,2,2,2,2;}{4,1,1,1,1,1,1,1,1,1;1,1,1,1,1,1,1,1,1,1;1,1,1,1,1,1,1,1,1,1;1,1,1,1,1,1,1,1,1,1;1,1,1,1,1,1,1,1,1,1;1,1,1,1,1,1,1,1,1,2;1,1,1,1,1,1,1,1,1,2;1,1,1,1,1,1,1,1,2,2;1,1,1,1,1,1,2,2,2,2;1,1,1,1,1,2,2,2,2,2;}{2,2,5,2,2,2,2,2,2,2;2,5,5,2,2,2,2,2,2,3;2,5,5,2,2,2,3,3,3,4;5,5,2,2,2,3,4,4,4,4;2,5,2,2,3,4,4,4,4,3;5,2,5,3,4,4,4,3,3,1;2,5,3,4,4,4,3,2,2,1;2,5,3,4,4,3,2,2,1,1;2,3,4,4,4,3,2,1,1,1;2,3,4,4,3,2,1,1,1,1;}{2,2,2,2,2,2,2,2,2,2;3,3,2,2,2,2,2,2,2,2;4,4,3,3,3,2,2,2,2,2;4,4,4,4,4,3,2,2,2,2;3,3,4,4,4,4,3,2,2,2;1,2,3,3,4,4,4,3,2,2;1,1,1,2,3,4,4,3,2,2;1,1,1,2,2,3,4,4,3,2;1,1,1,1,2,2,3,4,4,3;1,1,1,1,1,2,3,4,4,3;}{2,2,5,2,2,2,2,2,2,2;2,5,5,2,2,2,2,2,2,3;2,5,5,2,2,2,3,3,3,4;5,5,2,2,2,3,4,4,4,4;2,5,2,2,3,4,4,4,4,3;5,2,5,3,4,4,4,3,3,1;2,5,3,4,4,4,3,2,2,1;2,5,3,4,4,3,2,2,1,1;2,3,4,4,4,3,2,1,1,1;2,3,4,4,3,2,1,1,1,1;}{2,2,2,2,2,2,2,2,2,2;3,3,2,2,2,2,2,2,2,2;4,4,3,3,3,2,2,2,2,2;4,4,4,4,4,3,2,2,2,2;3,3,4,4,4,4,3,2,2,2;1,2,3,3,4,4,4,3,2,2;1,1,1,2,3,4,4,3,2,2;1,1,1,2,2,3,4,4,3,2;1,1,1,1,2,2,3,4,4,3;1,1,1,1,1,2,3,4,4,3;}
{3,1,1,1,1,1,1,1,1,1;1,1,1,1,1,1,1,1,1,1;1,1,1,5,1,5,1,1,1,1;1,1,1,1,1,1,1,1,1,1;1,1,5,1,1,1,5,1,1,1;1,1,1,5,5,5,1,1,1,2;1,1,1,1,1,1,1,1,1,2;1,1,1,1,1,1,1,1,2,2;1,1,1,1,1,1,2,2,2,2;1,1,1,1,1,2,2,2,2,2;}{4,1,1,1,1,1,1,1,1,1;1,1,1,1,1,1,1,1,1,1;1,1,1,1,1,1,1,1,1,1;1,1,1,1,1,1,1,1,1,1;1,1,1,1,1,1,1,1,1,1;1,1,1,1,1,1,1,1,1,2;1,1,1,1,1,1,1,1,1,2;1,1,1,1,1,1,1,1,2,2;1,1,1,1,1,1,2,2,2,2;1,1,1,1,1,2,2,2,2,2;}{2,2,5,2,2,2,2,2,2,2;2,5,5,2,2,2,2,2,2,3;2,5,5,2,2,2,3,3,3,4;5,5,2,2,2,3,4,4,4,4;2,5,2,2,3,4,4,4,4,3;5,2,5,3,4,4,4,3,3,1;2,5,3,4,4,4,3,2,2,1;2,5,3,4,4,3,2,2,1,1;2,3,4,4,4,3,2,1,1,1;2,3,4,4,3,2,1,1,1,1;}{2,2,2,2,2,2,2,2,2,2;3,3,2,2,2,2,2,2,2,2;4,4,3,3,3,2,2,2,2,2;4,4,4,4,4,3,2,2,2,2;3,3,4,4,4,4,3,2,2,2;1,2,3,3,4,4,4,3,2,2;1,1,1,2,3,4,4,3,2,2;1,1,1,2,2,3,4,4,3,2;1,1,1,1,2,2,3,4,4,3;1,1,1,1,1,2,3,4,4,3;}{2,2,5,2,2,2,2,2,2,2;2,5,5,2,2,2,2,2,2,3;2,5,5,2,2,2,3,3,3,4;5,5,2,2,2,3,4,4,4,4;2,5,2,2,3,4,4,4,4,3;5,2,5,3,4,4,4,3,3,1;2,5,3,4,4,4,3,2,2,1;2,5,3,4,4,3,2,2,1,1;2,3,4,4,4,3,2,1,1,1;2,3,4,4,3,2,1,1,1,1;}{2,2,2,2,2,2,2,2,2,2;3,3,2,2,2,2,2,2,2,2;4,4,3,3,3,2,2,2,2,2;4,4,4,4,4,3,2,2,2,2;3,3,4,4,4,4,3,2,2,2;1,2,3,3,4,4,4,3,2,2;1,1,1,2,3,4,4,3,2,2;1,1,1,2,2,3,4,4,3,2;1,1,1,1,2,2,3,4,4,3;1,1,1,1,1,2,3,4,4,3;}
Oi im walkin here
This is the third line
This is NOT the third line
But the crimes thy kind have committed against humanity are NOT forgotten....
And thy punishment... is DEATH!
